1 2 1 1
1 15 1 1
2 1 1 1
2 3 1 1
2 4 1 1
3 2 1 1
4 2 1 1
4 5 1 1
4 6 1 1
5 4 1 1
6 4 1 1
6 7 1 1
6 8 1 1
7 6 1 1
8 6 1 1
8 9 1 1
8 10 1 1
9 8 1 1
10 8 1 1
10 11 1 1
10 12 1 1
11 10 1 1
12 10 1 1
12 13 1 1
13 12 1 1
15 1 1 1
15 16 1 1
16 15 1 1
16 18 1 1
18 16 1 1
18 19 1 1
19 18 1 1
19 20 1 1
20 19 1 1
